I love this product!	positive
This is absolutely amazing!	positive
Great experience, highly recommend	positive
Fantastic quality and fast delivery	positive
I'm so happy with my purchase	positive
Excellent customer service ðŸ˜Š	positive
Best decision I ever made	positive
Wonderful, exceeded expectations	positive
I really enjoyed this	positive
This made my day!	positive
Terrible experience, very disappointed	negative
This is awful and broken	negative
I hate this so much	negative
Worst product ever	negative
Complete waste of money	negative
Horrible quality, do not buy	negative
I'm very upset and frustrated	negative
Absolutely terrible customer service	negative
This is garbage	negative
Never buying this again ðŸ˜¡	negative
It's okay, nothing special	neutral
This is fine I guess	neutral
Average product, works as expected	neutral
Not bad, not great	neutral
It's acceptable	neutral
Mediocre at best	neutral
Neither good nor bad	neutral
It works fine	neutral
Just average quality	neutral
Normal experience	neutral
